WE textures/3.png
SO textures/2.png
F   64,64,64                  
EA textures/4.png



C   55,64,64
NO textures/1.png

1111111111111111111111111111111111111
111111111000000000111011111111111101
111100010100011110111111111111111111
11110000000S000011000000001
11000010000000100000010001111111
1111010000000111110000001111100011
111111111111111  1111111111111111  111111
111111111111111  1111111111111111  111111
111111111  111111  1111111111111111  111111
111111111111111  1111111111111111  111111
111111111111111  1111111111111111  111111
111111111111111  1111111111111111  111111
111111111111111  1111111111111111  1111   11