NO textures/1.png
C 225,30,0
WE textures/3.png
EA textures/4.png
F 220,100,0
SO textures/2.png

        111111111111111111111111111
        1000000000110000000000000001
        101100000111000000000100011
        100100000000000000001100001
111111111011000001110000000001001111
100000000011000001110111111111111
11110111111111011100000010001
11110111111111011101010010001
11000000110101011100000010001
10000000000000001100000010001
10000000000E000011010100100001
11000001010101011111011110011 1
1111011111110101 101111010001
11111111 1111111 111111111111